111111111111111111111111111111111111111111111111111111111111111111111111111111111111111111111111111111111111111111111111
111111111111111111100000000333300011111111111111110000000000111111111111111111111111111111111111111111111111111111111111
111111111111111111100000000333300011111111111111110000000000111111111111111111111111111111111111111111111111111111111111
111111111111111111100000000333300011111111111111110000000000111111111111111111111111111111111111111111111111111111111111
111111111111111111100000000333300011111111111111110000000000111111111111111111111111111111111111111111111111111111111111
111110000000000000000000000000000000000000000000000000222222111111111111111111111111111111111111111111111111111111111111
111110000000000000000000000000000000000000000000000000003300111111111111111111111111111111111111111111111111111111111111
111110000000000000000000000000000000000000000000000000000000111111111111111111111111111111111111111111111111111111111111
111110000000000000000000000000000000000000000000000000000000111111111111111111111111111111111111111111111111111111111111
111110000000222222220000000000000111111111111100000000222222111111111111111111111111111111111111111111111111111111111111
111115555555335555520000000000000111111111111100000000000000111111000000000000000011111111111111111111111111111111111111
111115555555335555520000000000000111111111111100000000000000111111000000000000000011111111111111111111111111111111111111
111115555555555555520000000000000111111111111133000000111111111111000000000000000011111111111111111111111111111111111111
111115555555333335520000000000000111111111111133000000000000330000000000000000000011111111111111111111111111111111111111
111115555555333335520000000000000111111111111100000000000000000000000000000000000011111111111111111111111111111111111111
111110000000222222220000000000000111111111111111111111111111111111000000000000000011111111111111111111111111111111111111
111110000004200000000000000000000000000000000000000000111111100000000000000000000000000000000000000000000000000000011111
111110000004200000000000000000000000000000000000000000111111100000000000000000000000000000000000000000000000000000011111
111110000000200000000000000000000000000000000000000000111111100000000000000000000000000000000000000000000000000000011111
111110000000200000000000000000000111111111111111110000111111100000000000000000000000000000000000000000000000000000011111
111113300000233000000000000000000111111111111111110000111111100000000000000000000000001111110000000000000000000000011111
111113300000233000000000000000000111111111111111110000111111100000000000000000000000001111110000002222000000000000011111
111113300000222222227777777777777777711111111111110000111111100000000000000000000000001111110000002222000000000000011111
111110000000000000017777777777777777711111111111110000111111100000000000000000000000001111110000002222000000000000011111
111110000000000000017777777777777777711111111111110000000000000000000000000000000000001111110000002222000000000033311111
111110000000000000017777777777777777711111111111110000000000000000000000000000000000001111110000002222000000000033311111
111110000000000000017777777777777777711111111111110000000000000000000000000000000000001111110000002222000000000033311111
111110000000000000017777777777777777711111111111112222222222200000000000000000000000001111110000002222888888888888811111
111111111111111111110000000000000003311111111111112222222222200000000000000000000000001111110000002222888888888888811111
111110000000000000000000000000000003300000000000000022000000000000000000000000000000000000000000002222888888888888811111
111110000000000000000000000000000000000000000000000022000000000000000000000000000000000000000000001111888888888888811111
111110000000000000000000000000000000000000000000000000000000000000000000000000000000000000000000001111888888888888811111
111110000000000000000000000000000000000000000000000000000000000000000000000000000000000000000000001111888888888888811111
111110000000000000000000000000000003330000000000000000000000000000000000033000000000000000330000001111888888888888811111
111110000000000000000000000000000003330000000000000000000000000000000000033000000000000000330000001111000000000000011111
111110000000000000000000000000000000110000011111111111111111111111111111100000000001111111111111111111000000000000011111
111110000000000000000000000000000000110000011111111111111111111111111111100000000001111111111111111111000000000000001111
111110000000000000000000000000000000110000011111111111111111111111111111100000000001111111111111111111000000000000011111
111110000000000000000000000000000000110000011111111111111111111111111111111111111111111111111111111111000000000000011111
111111111111110000000000000000000000110000011111111111111111111111111111111111100000000000000000000000000000000000011111
111111111111110000000000000000000000110000011111111111111111111111111111111111100000000000000000000000000000000000011111
111111111111110000000000000000000000110000000000000000000000000000000000000000000000000000000000000000000000000000011111
111111111111110000000000000000000000110000000000000000000000000000000000000000000000000000000000000000000000000000011111
111111111111110000000000000000000000110000000000000000000000000000000000000000000000000000000000000000000000000000011111
111111111111110000000000000000000000110000000000000000000000000000000000000000000000000000000000000000000000000000011111
111111111111110000000000000000000000111111111111110000000000000000000000000000000000000000000000000000000000000000011111
111111111111110000000000000000000000111111111111110000000000000000000000000000000000000000000000000000000000000000011111
111111111111110000000000000000000000111111111111110000000000000000000000000000000000000000000000000000000000000000011111
111111111111110000000000000000000000111111111111110000000000000000000000000000000000000000000000000000000000000000011111
111111111111110000000000000000333333111111111111110000000000000000000000000000000000000000000000000000000000000000011111
111111111111110000000000000000033333111111111111110000000000000000000000000000000000000000000000000000000000000000011111
111111111111110000000000000000033333111111111111110000000000000000000000000000000000000000000000000000000000000000011111
111111111111110000000000000000033333111111111111110000000000000000000000000000000000000000000000000000000000000000011111
111111111110000000000000000000000000111111111111110000000000000000000000000000000000000000000000000000000000000000011111
111111111110000000000000000000000000111111111111110000000000000000000000000000000000000000000000000000000000000000011111
111111111110000000000000000000000000111111111111110000000000000000000000000000000000000000000000000000000000000000011111
111111111110001111111111000000111111111111111111110000000000000000000000000000000000000000000000000000000000000000011111
111111111113331111111111000000111111111111111111110000000000000000000000000000000000000000000000000000000000000000011111
111115555555554400000000000000000000000011111111110000000000000000000000000000000000000000000000000000000000000000011111
111115555555554400000000000000000000000011111111110000000000000000000000000000000000000000000000000000000000000000011111
111115555555550000000000000000000000003300001111110000000000000000000000000000000000000000000000000000000000000000011111
111115553333550000000000000000000000003300001111110000000000000000000000000000000000000000000000000000000000000000011111
111115553333550000000000000000000000000000001111110000000000000000000000000000000000000000000000000000000000000000011111
111113335555550000000000000000000000000000001100000000000000000000000000000000000000000000000000000000000000000000011111
111113335555550000000000000000000000000000001100000000000000001111000000000000000000000000000000000000000000000000011111
111110000000000000000000000000000000000011111100000000000000001111000000000000000000000000000000000000000000000000011111
111110000000000000000333000000000000000011111100000000000000001111000000000000000000000000000000000000000000000000011111
111110000000000000000333000000000000000011111100033000000000001111000000000000000000000000000000000000000333330000011111
111112222222222222222222220000000000011111111100033000000000001111000000000000000000000000000000000000000333330000011111
111112222222222222222222220000000000011111111100000000000000001111000000000000000000000000000000000000000333330000011111
111110003330000000000330000000000000011111111100000000000000001111000000000000000000000000000000000000000333330000011111
111110003330000000000000000000000000000000000000000000000000001111000000000000000000000000000000000000000333330000011111
111110000000000000000000000000000000000000000000000000333000001111000000000000000000000000000000000000000333330000011111
111110000000000000000000000000000000000000000000000000333000001111000000000000000000000000000000000000000000000000011111
111110000000000000000000000000000000000000000000000000333000001111000000000000000000000000000000000000000000000000011111
111110000333000000003330000000000011111111111111111111111111111111000000000000000000000000000000000000000000000000011111
111110000333000000003331100000000011111111111111111111111111111111000000000000000000000000000000000000000000000000011111
111111111111111111111111111111111111111111111111111111111111111111000000000000000000000000000000000000000000000000011111
111111111111111111111111111111111111111111111111111111111111111111111111111111111111111111111111111111111111111111111111
111111111111111111111111111111111111111111111111111111111111111111111111111111111111111111111111111111111111111111111111
111111111111111111111111111111111111111111111111111111111111111111111111111111111111111111111111111111111111111111111111
111111111111111111111111111111111111111111111111111111111111111111111111111111111111111111111111111111111111111111111111
111111111111111111111111111111111111111111111111111111111111111111111111111111111111111111111111111111111111111111111111
111111111111111111111111111111111111111111111111111111111111111111111111111111111111111111111111111111111111111111111111
111111111111111111111111111111111111111111111111111111111111111111111111111111111111111111111111111111111111111111111111
111111111111111111111111111111111111111111111111111111111111111111111111111111111111111111111111111111111111111111111111
000000000000000000000000000000000000000000000000000000000000000000000000000000000000000000000000000000000000000000000000
000000000000000000000000000000000000000000000000000000000000000000000000000000000000000000000000000000000000000000000000
000000000000000000000000000000000000000000000000000000000000000000000000000000000000000000000000000000000000000000000000
000000000000000000000000000000000000000000000000000000000000000000000000000000000000000000000000000000000000000000000000